000000000000000
003111111140000
002000000020000
002000000020000
002000000020000
002000000020000
002000000020000
002000000020000
